00000000000
00000000000
00000000000
00000000000
00000000000
01110111110
01000000010
01000000010
01000000010
01111111110
00000000000
